{
  "tiles": [
    "0", "0", "0", "0", "0", "0", "0", "0", "0", "0", "U", "0", "0", "0", "0", "0", "0", "0", "0",
    "0", "R", "0", "0", "0", "0", "0", "0", "0", "U", "0", "U", "0", "0", "0", "0", "0", "0", "0",
    "0", "0", "0", "0", "0", "0", "0", "0", "0", "0", "U", "0", "0", "0", "0", "0", "W", "0", "0",
    "B", "B", "B", "B", "B", "B", "B", "0", "0", "0", "0", "U", "0", "0", "0", "0", "0", "0", "0",
    "0", "0", "0", "B", "0", "0", "0", "0", "0", "0", "U", "0", "U", "0", "0", "0", "0", "0", "0",
    "b", "0", "B", "0", "0", "0", "0", "0", "0", "0", "0", "U", "0", "0", "0", "0", "0", "0", "0",
    "0", "B", "0", "0", "0", "0", "0", "0", "0", "0", "0", "0", "B", "0", "0", "0", "0", "0", "0",
    "0", "B", "0", "0", "0", "0", "0", "0", "0", "0", "0", "B", "0", "B", "0", "0", "0", "0", "0",
    "B", "0", "0", "0", "0", "0", "0", "0", "0", "0", "0", "0", "B", "0", "0", "0", "B", "0", "U",
    "B", "0", "0", "0", "0", "0", "0", "0", "0", "0", "0", "0", "0", "U", "0", "B", "0", "B", "0",
    "B", "0", "0", "0", "0", "0", "0", "0", "0", "0", "U", "0", "U", "0", "U", "0", "B", "0", "0",
    "0", "0", "0", "0", "0", "0", "0", "U", "0", "U", "0", "U", "0", "U", "0", "0", "0", "0", "0",
    "0", "0", "0", "0", "B", "0", "U", "0", "U", "0", "U", "0", "0", "0", "0", "0", "0", "0", "0",
    "0", "U", "0", "B", "0", "B", "0", "U", "0", "0", "0", "0", "0", "0", "0", "0", "0", "0", "0",
    "U", "0", "U", "0", "B", "0", "0", "0", "0", "0", "0", "0", "0", "0", "0", "0", "0", "0", "0",
    "0", "U", "0", "0", "0", "0", "0", "0", "0", "0", "0", "0", "0", "0", "0", "0", "0", "0", "0"
  ]
}
